//MAP CONVERTED BY dmm2tgm.py THIS HEADER COMMENT PREVENTS RECONVERSION, DO NOT REMOVE
"a" = (
/turf/template_noop,
/area/template_noop)
"b" = (
/obj/effect/turf_decal/siding/wideplating_new{
	dir = 8
	},
/obj/effect/turf_decal/siding/wideplating_new{
	dir = 4
	},
/turf/open/floor/iron/smooth_large,
/area/template_noop)
"c" = (
/obj/effect/turf_decal/siding/magenta_red{
	dir = 4
	},
/obj/structure/railing{
	dir = 4
	},
/turf/open/floor/iron/diagonal,
/area/template_noop)
"d" = (
/obj/structure/chair/sofa/bench/right{
	dir = 1
	},
/obj/effect/turf_decal/trimline/magenta_red/warning{
	dir = 1
	},
/obj/effect/turf_decal/trimline/magenta_red/mid_joiner{
	dir = 1
	},
/obj/effect/turf_decal/siding/thinplating_new{
	dir = 1
	},
/turf/open/floor/iron/half,
/area/template_noop)
"e" = (
/obj/effect/turf_decal/siding/wideplating_new{
	dir = 8
	},
/obj/structure/railing/corner/end/flip{
	dir = 1
	},
/obj/effect/turf_decal/trimline/magenta_red/filled/line{
	dir = 4
	},
/obj/effect/turf_decal/trimline/magenta_red/filled/mid_joiner{
	dir = 4
	},
/obj/effect/turf_decal/siding/thinplating_new{
	dir = 4
	},
/turf/open/floor/iron/smooth_large,
/area/template_noop)
"f" = (
/obj/effect/turf_decal/siding/wideplating_new{
	dir = 8
	},
/obj/effect/turf_decal/siding/wideplating_new{
	dir = 4
	},
/obj/machinery/door/airlock/maintenance_hatch,
/turf/open/floor/iron/smooth_large,
/area/template_noop)
"g" = (
/obj/machinery/light/directional/west,
/obj/effect/turf_decal/siding/wideplating_new{
	dir = 4
	},
/obj/structure/reagent_dispensers/fueltank,
/turf/open/floor/iron/smooth_large,
/area/template_noop)
"h" = (
/obj/effect/turf_decal/bot_red,
/turf/open/floor/plating,
/area/template_noop)
"i" = (
/obj/effect/turf_decal/trimline/magenta_red/warning,
/obj/effect/turf_decal/trimline/magenta_red/mid_joiner,
/obj/effect/turf_decal/siding/thinplating_new,
/obj/effect/turf_decal/siding/thinplating_new{
	dir = 1
	},
/turf/open/floor/iron/half,
/area/template_noop)
"j" = (
/obj/effect/turf_decal/siding/wideplating_new{
	dir = 4
	},
/obj/structure/table,
/obj/item/wrench,
/turf/open/floor/iron/smooth_large,
/area/template_noop)
"k" = (
/obj/effect/turf_decal/siding/wideplating_new{
	dir = 8
	},
/obj/effect/turf_decal/siding/wideplating_new{
	dir = 4
	},
/obj/machinery/door/firedoor/water_sensor,
/obj/structure/table/reinforced/plastitaniumglass,
/turf/open/floor/iron/smooth_large,
/area/template_noop)
"l" = (
/obj/effect/turf_decal/stripes/line{
	dir = 8
	},
/obj/effect/turf_decal/stripes/red/line{
	dir = 8
	},
/obj/effect/turf_decal/stripes/line{
	dir = 4
	},
/obj/effect/turf_decal/stripes/red/line{
	dir = 4
	},
/turf/open/floor/pod,
/area/template_noop)
"m" = (
/obj/effect/turf_decal/siding/magenta_red/corner{
	dir = 4
	},
/obj/structure/railing/corner{
	dir = 4
	},
/turf/open/floor/iron/diagonal,
/area/template_noop)
"n" = (
/obj/effect/turf_decal/siding/magenta_red,
/obj/structure/railing,
/turf/open/floor/iron/diagonal,
/area/template_noop)
"o" = (
/obj/effect/turf_decal/siding/wideplating_new{
	dir = 4
	},
/obj/structure/table,
/obj/item/weldingtool/mini/empty,
/turf/open/floor/iron/smooth_large,
/area/template_noop)
"p" = (
/obj/effect/turf_decal/siding/wideplating_new{
	dir = 8
	},
/obj/structure/railing/corner/end,
/obj/effect/turf_decal/trimline/magenta_red/filled/line{
	dir = 4
	},
/obj/effect/turf_decal/trimline/magenta_red/filled/mid_joiner{
	dir = 4
	},
/obj/effect/turf_decal/siding/thinplating_new{
	dir = 4
	},
/turf/open/floor/iron/smooth_large,
/area/template_noop)
"q" = (
/obj/structure/hedge,
/obj/effect/turf_decal/trimline/magenta_red/warning{
	dir = 1
	},
/obj/effect/turf_decal/trimline/magenta_red/mid_joiner{
	dir = 1
	},
/obj/effect/turf_decal/siding/thinplating_new{
	dir = 1
	},
/turf/open/floor/iron/half,
/area/template_noop)
"r" = (
/obj/structure/railing,
/obj/structure/closet/emcloset,
/turf/open/floor/catwalk_floor/iron,
/area/template_noop)
"s" = (
/obj/machinery/light/directional/north,
/turf/open/floor/catwalk_floor/iron_dark,
/area/template_noop)
"t" = (
/obj/effect/turf_decal/trimline/magenta_red/warning,
/obj/effect/turf_decal/trimline/magenta_red/mid_joiner,
/obj/effect/turf_decal/siding/thinplating_new,
/obj/effect/turf_decal/siding/thinplating_new/corner{
	dir = 1
	},
/obj/structure/chair/sofa/bench/solo,
/turf/open/floor/iron/half,
/area/template_noop)
"u" = (
/obj/effect/turf_decal/stripes/line{
	dir = 8
	},
/obj/effect/turf_decal/stripes/red/line{
	dir = 8
	},
/obj/effect/turf_decal/stripes/line{
	dir = 4
	},
/obj/effect/turf_decal/stripes/red/line{
	dir = 4
	},
/obj/effect/turf_decal/arrows/red,
/turf/open/floor/pod,
/area/template_noop)
"v" = (
/obj/effect/spawner/liquids_spawner,
/turf/open/floor/iron/lowered,
/area/template_noop)
"w" = (
/obj/effect/turf_decal/stripes/end{
	dir = 1
	},
/obj/effect/turf_decal/stripes/red/end{
	dir = 1
	},
/obj/effect/turf_decal/arrows/red,
/turf/open/floor/pod,
/area/template_noop)
"x" = (
/turf/open/floor/plating,
/area/template_noop)
"y" = (
/obj/effect/turf_decal/siding/magenta_red/corner,
/obj/structure/railing/corner,
/turf/open/floor/iron/diagonal,
/area/template_noop)
"z" = (
/obj/structure/chair/sofa/bench/left{
	dir = 1
	},
/obj/effect/turf_decal/trimline/magenta_red/warning{
	dir = 1
	},
/obj/effect/turf_decal/trimline/magenta_red/mid_joiner{
	dir = 1
	},
/obj/effect/turf_decal/siding/thinplating_new{
	dir = 1
	},
/turf/open/floor/iron/half,
/area/template_noop)
"A" = (
/turf/open/floor/catwalk_floor/iron_dark,
/area/template_noop)
"B" = (
/turf/closed/wall/mineral/titanium/nodiagonal,
/area/template_noop)
"C" = (
/obj/effect/turf_decal/siding/magenta_red/corner{
	dir = 1
	},
/obj/structure/railing/corner{
	dir = 1
	},
/obj/machinery/airalarm/directional/east,
/turf/open/floor/iron/diagonal,
/area/template_noop)
"D" = (
/obj/effect/turf_decal/stripes/line{
	dir = 1
	},
/obj/effect/turf_decal/stripes/red/line{
	dir = 1
	},
/turf/open/floor/plating/elevatorshaft,
/area/template_noop)
"E" = (
/turf/open/floor/plating/rust,
/area/template_noop)
"F" = (
/obj/effect/turf_decal/stripes/line{
	dir = 8
	},
/obj/effect/turf_decal/stripes/red/line{
	dir = 8
	},
/obj/effect/turf_decal/stripes/line{
	dir = 4
	},
/obj/effect/turf_decal/stripes/red/line{
	dir = 4
	},
/obj/effect/decal/cleanable/oil/streak,
/turf/open/floor/pod,
/area/template_noop)
"G" = (
/obj/effect/turf_decal/siding/wideplating_new{
	dir = 8
	},
/obj/effect/turf_decal/trimline/magenta_red/filled/line{
	dir = 4
	},
/obj/effect/turf_decal/trimline/magenta_red/filled/mid_joiner{
	dir = 4
	},
/obj/effect/turf_decal/siding/thinplating_new{
	dir = 4
	},
/obj/machinery/light/floor,
/turf/open/floor/iron/smooth_large,
/area/template_noop)
"H" = (
/obj/effect/spawner/structure/window/reinforced/shuttle,
/turf/open/floor/plating,
/area/template_noop)
"I" = (
/obj/effect/turf_decal/stripes/line{
	dir = 8
	},
/obj/effect/turf_decal/stripes/red/line{
	dir = 8
	},
/obj/effect/turf_decal/stripes/line{
	dir = 4
	},
/obj/effect/turf_decal/stripes/red/line{
	dir = 4
	},
/obj/effect/decal/cleanable/oil,
/turf/open/floor/pod,
/area/template_noop)
"J" = (
/turf/open/floor/catwalk_floor/iron,
/area/template_noop)
"K" = (
/obj/structure/sign/poster/contraband/rip_badger/directional/north,
/obj/structure/railing/corner/end/flip{
	dir = 8
	},
/turf/open/floor/catwalk_floor/iron,
/area/template_noop)
"L" = (
/obj/effect/turf_decal/sand/plating,
/obj/effect/turf_decal/stripes/asteroid/line{
	dir = 1
	},
/obj/effect/turf_decal/stripes/asteroid/line,
/obj/structure/fans/tiny/shield,
/turf/open/floor/plating,
/area/template_noop)
"M" = (
/obj/effect/turf_decal/trimline/magenta_red/warning,
/obj/effect/turf_decal/siding/thinplating_new,
/obj/effect/turf_decal/trimline/magenta_red/mid_joiner,
/obj/effect/turf_decal/siding/thinplating_new{
	dir = 1
	},
/turf/open/floor/iron/half,
/area/template_noop)
"N" = (
/turf/open/floor/plating/elevatorshaft,
/area/template_noop)
"O" = (
/obj/effect/turf_decal/bot_red,
/obj/effect/turf_decal/stripes/line{
	dir = 1
	},
/obj/effect/turf_decal/stripes/red/line{
	dir = 1
	},
/turf/open/floor/plating/rust,
/area/template_noop)
"P" = (
/obj/effect/turf_decal/siding/magenta_red{
	dir = 1
	},
/obj/structure/railing{
	dir = 1
	},
/turf/open/floor/iron/diagonal,
/area/template_noop)
"Q" = (
/obj/structure/reagent_dispensers/water_cooler,
/obj/effect/turf_decal/trimline/magenta_red/warning{
	dir = 1
	},
/obj/effect/turf_decal/trimline/magenta_red/mid_joiner{
	dir = 1
	},
/obj/effect/turf_decal/siding/thinplating_new{
	dir = 1
	},
/obj/machinery/light/directional/west,
/turf/open/floor/iron/half,
/area/template_noop)
"R" = (
/obj/effect/turf_decal/siding/wideplating_new{
	dir = 4
	},
/obj/effect/decal/cleanable/oil/streak,
/turf/open/floor/iron/smooth_large,
/area/template_noop)
"S" = (
/obj/effect/turf_decal/siding/magenta_red/corner{
	dir = 8
	},
/obj/structure/railing/corner{
	dir = 8
	},
/turf/open/floor/iron/diagonal,
/area/template_noop)
"T" = (
/obj/effect/turf_decal/siding/wideplating_new{
	dir = 4
	},
/obj/structure/closet/crate,
/obj/item/gps/spaceruin,
/obj/effect/spawner/random/entertainment/money_small,
/obj/effect/spawner/random/entertainment/cigarette_pack,
/turf/open/floor/iron/smooth_large,
/area/template_noop)
"U" = (
/obj/effect/turf_decal/bot_red,
/turf/open/floor/plating/rust,
/area/template_noop)
"V" = (
/obj/effect/turf_decal/siding/wideplating_new{
	dir = 8
	},
/obj/structure/railing{
	dir = 8
	},
/obj/effect/turf_decal/trimline/magenta_red/filled/line{
	dir = 4
	},
/obj/effect/turf_decal/trimline/magenta_red/filled/mid_joiner{
	dir = 4
	},
/obj/effect/turf_decal/siding/thinplating_new{
	dir = 4
	},
/turf/open/floor/iron/smooth_large,
/area/template_noop)
"W" = (
/obj/effect/turf_decal/bot_red,
/obj/effect/turf_decal/stripes/line{
	dir = 1
	},
/obj/effect/turf_decal/stripes/red/line{
	dir = 1
	},
/turf/open/floor/plating,
/area/template_noop)
"X" = (
/obj/effect/turf_decal/siding/magenta_red{
	dir = 8
	},
/obj/structure/railing{
	dir = 8
	},
/turf/open/floor/iron/diagonal,
/area/template_noop)
"Y" = (
/obj/effect/turf_decal/trimline/magenta_red/warning,
/obj/effect/turf_decal/trimline/magenta_red/mid_joiner,
/obj/effect/turf_decal/siding/thinplating_new,
/obj/structure/extinguisher_cabinet/directional/north,
/turf/open/floor/iron/half,
/area/template_noop)
"Z" = (
/obj/machinery/light/directional/north,
/turf/open/floor/catwalk_floor/iron,
/area/template_noop)

(1,1,1) = {"
a
a
a
a
a
a
a
a
a
a
a
a
a
a
a
a
a
a
a
a
a
a
a
a
a
a
a
a
a
a
a
a
a
a
a
a
a
a
a
a
a
a
a
a
a
a
a
a
a
a
"}
(2,1,1) = {"
a
a
a
a
a
a
a
a
a
a
a
a
a
a
a
a
a
a
a
a
a
a
a
a
a
a
a
a
a
a
a
a
a
a
a
a
a
a
a
a
a
a
a
a
a
a
a
a
a
a
"}
(3,1,1) = {"
a
a
a
a
a
a
a
a
a
a
a
a
a
a
a
a
a
a
a
a
a
a
a
a
a
a
a
a
a
a
a
a
a
a
a
a
a
a
a
a
a
a
a
a
a
a
a
a
a
a
"}
(4,1,1) = {"
a
a
a
a
a
a
a
a
a
a
a
a
a
a
a
a
a
a
a
a
a
a
a
a
a
a
a
a
a
a
a
a
a
a
a
a
a
a
a
a
a
a
a
a
a
a
a
a
a
a
"}
(5,1,1) = {"
a
a
a
a
a
a
a
a
a
a
a
a
a
a
a
a
a
a
a
a
a
a
a
a
a
a
a
a
a
a
a
a
a
a
a
a
a
a
a
a
a
a
a
a
a
a
a
a
a
a
"}
(6,1,1) = {"
a
a
a
a
a
a
a
a
a
a
a
a
a
a
a
a
a
a
a
a
a
a
a
a
a
a
a
a
a
a
a
a
a
a
a
a
a
a
a
a
a
a
a
a
a
a
a
a
a
a
"}
(7,1,1) = {"
a
a
a
a
a
a
a
a
a
a
a
a
a
a
a
a
a
a
a
a
a
a
a
a
a
a
a
a
a
a
a
a
a
a
a
a
a
a
a
a
a
a
a
a
a
a
a
a
a
a
"}
(8,1,1) = {"
a
a
a
a
a
a
a
a
a
a
a
a
a
a
a
a
a
a
a
a
a
a
a
a
a
a
a
a
a
a
a
a
a
a
a
a
a
a
a
a
a
a
a
a
a
a
a
a
a
a
"}
(9,1,1) = {"
a
a
a
a
a
a
a
a
a
a
a
a
a
a
a
a
a
a
a
a
a
a
a
a
a
a
a
a
a
a
a
a
a
a
a
a
a
a
a
a
a
a
a
a
a
a
a
a
a
a
"}
(10,1,1) = {"
a
a
a
a
a
a
a
a
a
a
a
a
a
a
a
a
a
a
a
a
a
a
a
a
a
a
a
a
a
a
a
a
a
a
a
a
a
a
a
a
a
a
a
a
a
a
a
a
a
a
"}
(11,1,1) = {"
a
a
a
a
a
a
a
a
a
a
a
a
a
a
a
a
a
a
a
a
a
a
a
a
a
a
a
a
a
a
a
a
a
a
a
a
a
a
a
a
a
a
a
a
a
a
a
a
a
a
"}
(12,1,1) = {"
a
a
a
a
a
a
a
a
a
a
a
a
a
a
a
a
a
a
a
a
B
H
H
B
H
H
B
a
a
a
a
a
a
a
a
a
a
a
a
a
a
a
a
a
a
a
a
a
a
a
"}
(13,1,1) = {"
a
a
a
a
a
a
a
a
a
a
a
a
a
a
a
a
a
a
a
B
B
T
R
g
j
o
B
B
a
a
a
a
a
a
a
a
a
a
a
a
a
a
a
a
a
a
a
a
a
a
"}
(14,1,1) = {"
a
a
a
a
a
a
a
a
a
a
a
a
a
a
a
a
a
a
B
B
W
x
E
U
x
E
U
L
a
a
a
a
a
a
a
a
a
a
a
a
a
a
a
a
a
a
a
a
a
a
"}
(15,1,1) = {"
a
a
a
a
a
a
a
a
a
a
a
a
a
a
a
a
a
a
B
r
w
l
I
u
l
l
u
L
a
a
a
a
a
a
a
a
a
a
a
a
a
a
a
a
a
a
a
a
a
a
"}
(16,1,1) = {"
a
a
a
a
a
a
a
a
a
a
a
a
a
a
a
a
a
a
B
K
D
N
N
N
N
N
N
L
a
a
a
a
a
a
a
a
a
a
a
a
a
a
a
a
a
a
a
a
a
a
"}
(17,1,1) = {"
a
a
a
a
a
a
a
a
a
a
a
a
a
a
a
a
a
a
B
Z
w
l
l
u
l
F
u
L
a
a
a
a
a
a
a
a
a
a
a
a
a
a
a
a
a
a
a
a
a
a
"}
(18,1,1) = {"
a
a
a
a
a
a
a
a
a
a
a
a
a
a
a
a
a
a
B
J
O
x
x
U
x
x
h
L
a
a
a
a
a
a
a
a
a
a
a
a
a
a
a
a
a
a
a
a
a
a
"}
(19,1,1) = {"
a
a
a
a
a
a
a
a
a
a
a
a
a
a
a
a
a
a
B
f
B
V
e
G
p
V
B
B
a
a
a
a
a
a
a
a
a
a
a
a
a
a
a
a
a
a
a
a
a
a
"}
(20,1,1) = {"
a
a
a
a
a
a
a
a
a
a
a
a
a
a
a
a
a
a
B
A
M
y
c
c
c
m
Q
B
a
a
a
a
a
a
a
a
a
a
a
a
a
a
a
a
a
a
a
a
a
a
"}
(21,1,1) = {"
a
a
a
a
a
a
a
a
a
a
a
a
a
a
a
a
a
a
B
s
i
n
v
v
v
P
z
H
a
a
a
a
a
a
a
a
a
a
a
a
a
a
a
a
a
a
a
a
a
a
"}
(22,1,1) = {"
a
a
a
a
a
a
a
a
a
a
a
a
a
a
a
a
a
a
B
B
t
n
v
v
v
P
d
H
a
a
a
a
a
a
a
a
a
a
a
a
a
a
a
a
a
a
a
a
a
a
"}
(23,1,1) = {"
a
a
a
a
a
a
a
a
a
a
a
a
a
a
a
a
a
a
a
B
Y
S
X
X
X
C
q
B
a
a
a
a
a
a
a
a
a
a
a
a
a
a
a
a
a
a
a
a
a
a
"}
(24,1,1) = {"
a
a
a
a
a
a
a
a
a
a
a
a
a
a
a
a
a
a
a
B
b
B
k
k
k
B
B
B
a
a
a
a
a
a
a
a
a
a
a
a
a
a
a
a
a
a
a
a
a
a
"}
(25,1,1) = {"
a
a
a
a
a
a
a
a
a
a
a
a
a
a
a
a
a
a
a
a
a
a
a
a
a
a
a
a
a
a
a
a
a
a
a
a
a
a
a
a
a
a
a
a
a
a
a
a
a
a
"}
(26,1,1) = {"
a
a
a
a
a
a
a
a
a
a
a
a
a
a
a
a
a
a
a
a
a
a
a
a
a
a
a
a
a
a
a
a
a
a
a
a
a
a
a
a
a
a
a
a
a
a
a
a
a
a
"}
(27,1,1) = {"
a
a
a
a
a
a
a
a
a
a
a
a
a
a
a
a
a
a
a
a
a
a
a
a
a
a
a
a
a
a
a
a
a
a
a
a
a
a
a
a
a
a
a
a
a
a
a
a
a
a
"}
(28,1,1) = {"
a
a
a
a
a
a
a
a
a
a
a
a
a
a
a
a
a
a
a
a
a
a
a
a
a
a
a
a
a
a
a
a
a
a
a
a
a
a
a
a
a
a
a
a
a
a
a
a
a
a
"}
(29,1,1) = {"
a
a
a
a
a
a
a
a
a
a
a
a
a
a
a
a
a
a
a
a
a
a
a
a
a
a
a
a
a
a
a
a
a
a
a
a
a
a
a
a
a
a
a
a
a
a
a
a
a
a
"}
(30,1,1) = {"
a
a
a
a
a
a
a
a
a
a
a
a
a
a
a
a
a
a
a
a
a
a
a
a
a
a
a
a
a
a
a
a
a
a
a
a
a
a
a
a
a
a
a
a
a
a
a
a
a
a
"}
(31,1,1) = {"
a
a
a
a
a
a
a
a
a
a
a
a
a
a
a
a
a
a
a
a
a
a
a
a
a
a
a
a
a
a
a
a
a
a
a
a
a
a
a
a
a
a
a
a
a
a
a
a
a
a
"}
(32,1,1) = {"
a
a
a
a
a
a
a
a
a
a
a
a
a
a
a
a
a
a
a
a
a
a
a
a
a
a
a
a
a
a
a
a
a
a
a
a
a
a
a
a
a
a
a
a
a
a
a
a
a
a
"}
(33,1,1) = {"
a
a
a
a
a
a
a
a
a
a
a
a
a
a
a
a
a
a
a
a
a
a
a
a
a
a
a
a
a
a
a
a
a
a
a
a
a
a
a
a
a
a
a
a
a
a
a
a
a
a
"}
(34,1,1) = {"
a
a
a
a
a
a
a
a
a
a
a
a
a
a
a
a
a
a
a
a
a
a
a
a
a
a
a
a
a
a
a
a
a
a
a
a
a
a
a
a
a
a
a
a
a
a
a
a
a
a
"}
(35,1,1) = {"
a
a
a
a
a
a
a
a
a
a
a
a
a
a
a
a
a
a
a
a
a
a
a
a
a
a
a
a
a
a
a
a
a
a
a
a
a
a
a
a
a
a
a
a
a
a
a
a
a
a
"}
(36,1,1) = {"
a
a
a
a
a
a
a
a
a
a
a
a
a
a
a
a
a
a
a
a
a
a
a
a
a
a
a
a
a
a
a
a
a
a
a
a
a
a
a
a
a
a
a
a
a
a
a
a
a
a
"}
(37,1,1) = {"
a
a
a
a
a
a
a
a
a
a
a
a
a
a
a
a
a
a
a
a
a
a
a
a
a
a
a
a
a
a
a
a
a
a
a
a
a
a
a
a
a
a
a
a
a
a
a
a
a
a
"}
(38,1,1) = {"
a
a
a
a
a
a
a
a
a
a
a
a
a
a
a
a
a
a
a
a
a
a
a
a
a
a
a
a
a
a
a
a
a
a
a
a
a
a
a
a
a
a
a
a
a
a
a
a
a
a
"}
(39,1,1) = {"
a
a
a
a
a
a
a
a
a
a
a
a
a
a
a
a
a
a
a
a
a
a
a
a
a
a
a
a
a
a
a
a
a
a
a
a
a
a
a
a
a
a
a
a
a
a
a
a
a
a
"}
(40,1,1) = {"
a
a
a
a
a
a
a
a
a
a
a
a
a
a
a
a
a
a
a
a
a
a
a
a
a
a
a
a
a
a
a
a
a
a
a
a
a
a
a
a
a
a
a
a
a
a
a
a
a
a
"}
(41,1,1) = {"
a
a
a
a
a
a
a
a
a
a
a
a
a
a
a
a
a
a
a
a
a
a
a
a
a
a
a
a
a
a
a
a
a
a
a
a
a
a
a
a
a
a
a
a
a
a
a
a
a
a
"}
(42,1,1) = {"
a
a
a
a
a
a
a
a
a
a
a
a
a
a
a
a
a
a
a
a
a
a
a
a
a
a
a
a
a
a
a
a
a
a
a
a
a
a
a
a
a
a
a
a
a
a
a
a
a
a
"}
(43,1,1) = {"
a
a
a
a
a
a
a
a
a
a
a
a
a
a
a
a
a
a
a
a
a
a
a
a
a
a
a
a
a
a
a
a
a
a
a
a
a
a
a
a
a
a
a
a
a
a
a
a
a
a
"}
(44,1,1) = {"
a
a
a
a
a
a
a
a
a
a
a
a
a
a
a
a
a
a
a
a
a
a
a
a
a
a
a
a
a
a
a
a
a
a
a
a
a
a
a
a
a
a
a
a
a
a
a
a
a
a
"}
(45,1,1) = {"
a
a
a
a
a
a
a
a
a
a
a
a
a
a
a
a
a
a
a
a
a
a
a
a
a
a
a
a
a
a
a
a
a
a
a
a
a
a
a
a
a
a
a
a
a
a
a
a
a
a
"}
(46,1,1) = {"
a
a
a
a
a
a
a
a
a
a
a
a
a
a
a
a
a
a
a
a
a
a
a
a
a
a
a
a
a
a
a
a
a
a
a
a
a
a
a
a
a
a
a
a
a
a
a
a
a
a
"}
(47,1,1) = {"
a
a
a
a
a
a
a
a
a
a
a
a
a
a
a
a
a
a
a
a
a
a
a
a
a
a
a
a
a
a
a
a
a
a
a
a
a
a
a
a
a
a
a
a
a
a
a
a
a
a
"}
(48,1,1) = {"
a
a
a
a
a
a
a
a
a
a
a
a
a
a
a
a
a
a
a
a
a
a
a
a
a
a
a
a
a
a
a
a
a
a
a
a
a
a
a
a
a
a
a
a
a
a
a
a
a
a
"}
(49,1,1) = {"
a
a
a
a
a
a
a
a
a
a
a
a
a
a
a
a
a
a
a
a
a
a
a
a
a
a
a
a
a
a
a
a
a
a
a
a
a
a
a
a
a
a
a
a
a
a
a
a
a
a
"}
(50,1,1) = {"
a
a
a
a
a
a
a
a
a
a
a
a
a
a
a
a
a
a
a
a
a
a
a
a
a
a
a
a
a
a
a
a
a
a
a
a
a
a
a
a
a
a
a
a
a
a
a
a
a
a
"}
